###########
#A        #
# ####### #
#       # #
# ##### # #
#     # #B#
###########
