#######################
#A#     #             #
# # ### # ############ 
# #   # #              
# ### # ############## 
#     # #          #  B
###### # # ###### # ##
#      # # #      #   
# #### # # # #### ### 
#    # # # # #    #   
#### # # # # # #### # 
     # # # # #      # 
###### # # # ###### # 
#      # # # #      # 
# ############ ####   
###################