#########
#A     ##
### ### #
#   #   #
# ### ##B
#########